11111111111111
10000012000001
15100014413001
11100000011001
13102100011101
10001110021201
14441110011141
10002000000601
11111111111111
