11111111111
15030204011
10002402011
10411110011
12011114211
10211110011
13411110011
10000020611
11      111
