0000000000
0000000000
0020002000
0030040600
0000040000
0002000000
0032000000
0002005000
0000000000
0000000000