1111111111
1000000001
1020002001
1030040601
1000040001
1002000001
1032000001
1002005001
1000000001
1111111111