1111111111111
1111111111111
1111111111111
1115030204011
1110002402011
1110411110011
1112011114211
1110211110011
1113411110011
1110000020611
