11111111111111
15030204011111
10002402011111
10411000000001
12011114211111
10211001111111
13411110011111
10000020611111
11000000111111
